#####################################################################
## . . . . . . . . . . . . . . . . . . . . . . . . . . . . . . . . ##
## . . . . . . . . . . . . . . . . . . . . . . . . . . . . . . . . ##
## . . . . . . . . . . . . . . . . . . . . . . . . . . . . . . . . ## 
## . . . . . . . . . . . . . . . . . . . . . . . . . . . . . . . . ##
## . . . . . . . . . . . . . . . . . . . . . . . . . . . . . . . . ##
## . . . . . . . . . . . . . . . . . . . . . . . . . . . . . . . . ##
## . . . . . . . . . . . . . . . . . . . . . . . . . . . . . . . . ##
## . . . . . . . . . . . . . . . . . . . . . . . . . . . . . . . . ##
## . . . . . # . . . . . . . . . . . . . . . . . . . . # . . . . . ##
## . . . . . # . ######### . . . . . . . . ######### . # . . . . . ##
########## . # . . . . . # . ####   #### . # . . . . . # . ##########
########## . # . ##### . # . #         # . # . ##### . # . ##########
 . . . . . . . . # . . . # . #         # . # . . . # . . . . . . . . 
########## . # . # . ##### . ########### . ##### . # . # . ##########
########## . # . # . . . . . . . . . . . . . . . . # . # . ##########
## . . . . . # . . . ##### . . ####### . . ##### . . . # . . . . . ##
## . # . # . ##### . # . # . ########### . # . # . ##### . # . # . ##
###### . # . # . # . # . . . . . ### . . . . . # . # . # . # . ###### 
## . . . . . . . . . # . ##### . . . . ##### . # . . . . . . . . . ##
## . ##### . ############# . . . ### . . . ############# . ##### . ##
## . . . # . . . . . . . . . # . . . . # . . . . . . . . . # . . . ##
###### . # . # . ############### . . ############### . # . # . ######
## . . . . . # . . . . . # . . . . . . . . # . . . . . # . . . . . ##
## . ################# . ### . ####### . ### . ################# . ## 
## . . . . . . . . . . . . . . . . . . . . . . . . . . . . . . . . ##
#####################################################################
