#####################################################################
## . . . . . . . . . . . . . . . . . . . . . . . . . . . . . . . . ##
## . . . . . . . . . . . . . . . . . . . . . . . . . . . . . . . . ##
## . . . . . . . . . . . . . . . . . . . . . . . . . . . . . . . . ## 
## . . . . . . . . . . . . . . . . . . . . . . . . . . . . . . . . ##
## . . . . . . . . . . . . . . . . . . . . . . . . . . . . . . . . ##
## . . . . . . . . . . . . . . . . . . . . . . . . . . . . . . . . ##
## . . . . . . . . . . . . . . . . . . . . . . . . . . . . . . . . ##
## . . . . . . . . . . . . . . . . . . . . . . . . . . . . . . . . ##
## . . . . . # . . . . . . . . . . . . . . . . . . . . # . . . . . ##
## . . . . . # . ######### . . . . . . . . ######### . # . . . . . ##
## . ##### . # . . . . . # . ####   #### . # . . . . . # . ##### . ##
## . ##### . # . ##### . # . #         # . # . ##### . # . ##### . ##
## . . . . . . . # . . . # . #         # . # . . . # . . . . . . . ## 
########## . # . # . ##### . ########### . ##### . # . # . ##########
########## . # . # . . . . . . . . . . . . . . . . # . # . ##########
## . . . . . # . . . ##### . . ## T ## . . ##### . . . # . . . . . ##
## . # . # . ##### . # . # . ########### . # . # . ##### . # . # . ##
###### . # . # . # . # . . . . . ### . . . . . # . # . # . # . ###### 
## . . . . . . . . . # B ##### . . . . ##### B # . . . . . . . . . ##
## . ##### . ############# . . . ### . . . ############# . ##### . ##
## . . . # . . . . . . . . . # . . . . # . . . . . . . . . # . . . ##
###### . # . # . ############### . . ############### . # . # . ######
## . . . . . # . . . . . # . . . . . . . . # . . . . . # . . . . . ##
## . ################# . ### . ####### . ### . ################# . ## 
## . . . . . . . . . . . . . . . . . . . . . . . . . . . . . . . . ##
#####################################################################
