###################################################
## . . . . . . . . . . . # . . . . . . . . . . . ##
## . ##### . ######### . # . ######### . ##### . ##
## . # B . . ######### . # . ######### . . B # . ##
## . # . # . ######### . # . ######### . # . # . ##
## . . . . . . . . . . . . . . . . . . . . . . . ##
## . ##### . # . ################# . # . ##### . ##
## . . . . . # . . . . . # . . . . . # . . . . . ##
## . ##### . ######### . # . ######### . ##### . ##
## . ##### . # . . . . & 0 @ . . . . # . ##### . ##
## . . . . . # . ################# . # . . . . . ##
########## . # . #               # . # . ##########
T  . . . . . . . #               # . . . . . . .  T
########## . # . #               # . # . ##########
## B . . # . # . ################# . # . # . . B ##
## . # . # . # . . . . . . . . . . . # . # . # . ##
## . # . # . # . ################# . # . # . # . ##
## . . . . . . . . . . . # . . . . . . . . . . . ##
## . ##### . ######### . # . ######### . ##### . ##
## . . . # . . . . . . . . . . . . . . . # . . . ##
###### . # . # . ################# . # . # . ######
## . . . . . # . . . . . # . . . . . # . . . . . ##
## . ################# . # . ################# . ##
## . . . . . . . . . . . p . . . . . . . . . . . ##
###################################################
#
#
#
#
#
#
#
#
#
#
#
#
#
#
#
#
#
#
#
#
#
#
#
#
#
#
#
#
#
#
#
#
#
#
#